11111111111111
100100010000C1
1C0P0100000E01
100100010000C1
11111111111111