1111111
1111111
11PEC11
1111111
1111111