11111111111111
100100010001C1
1C0P0100001E11
100100010001C1
11111111111111